[
  {
    "level": "1",
    "questionIdList": [
      3, 4, 5, 6, 7, 9, 10, 11, 12, 13, 15, 16, 17, 18, 19, 21, 22, 23, 24, 25,
      27, 28, 29, 30, 31
    ]
  },
  {
    "level": "2",
    "questionIdList": [
      34, 35, 36, 37, 38, 40, 41, 42, 43, 44, 46, 47, 48, 49, 50, 52, 53, 54,
      55, 56, 58, 59, 60, 61, 62
    ]
  },
  {
    "level": "3",
    "questionIdList": [
      65, 66, 67, 68, 69, 71, 72, 73, 74, 75, 77, 78, 79, 80, 81, 83, 84, 85,
      86, 87, 89, 90, 91, 92, 93
    ]
  },
  {
    "level": "4",
    "questionIdList": [
      96, 97, 98, 99, 100, 102, 103, 104, 105, 106, 108, 109, 110, 111, 112,
      114, 115, 116, 117, 118, 120, 121, 122, 123, 124
    ]
  },
  {
    "level": "5",
    "questionIdList": [
      127, 128, 129, 130, 131, 133, 134, 135, 136, 137, 139, 140, 141, 142, 143,
      145, 146, 147, 148, 149, 151, 152, 153, 154, 155
    ]
  },
  {
    "level": "6",
    "questionIdList": [
      158, 159, 160, 161, 162, 164, 165, 166, 167, 168, 170, 171, 172, 173, 174,
      176, 177, 178, 179, 180, 182, 183, 184, 185, 186
    ]
  },
  {
    "level": "7",
    "questionIdList": [
      189, 190, 191, 192, 193, 195, 196, 197, 198, 199, 201, 202, 203, 204, 205,
      207, 208, 209, 210, 211, 213, 214, 215, 216, 217
    ]
  },
  {
    "level": "8",
    "questionIdList": [
      220, 221, 222, 223, 224, 226, 227, 228, 229, 230, 232, 233, 234, 235, 236,
      238, 239, 240, 241, 242, 244, 245, 246, 247, 248
    ]
  }
]
