{
  "3": "1",
  "4": "1",
  "5": "1",
  "6": "1",
  "7": "1",
  "9": "1",
  "10": "1",
  "11": "1",
  "12": "1",
  "13": "1",
  "15": "1",
  "16": "1",
  "17": "1",
  "18": "1",
  "19": "1",
  "21": "1",
  "22": "1",
  "23": "1",
  "24": "1",
  "25": "1",
  "27": "1",
  "28": "1",
  "29": "1",
  "30": "1",
  "31": "1",
  "34": "2",
  "35": "2",
  "36": "2",
  "37": "2",
  "38": "2",
  "40": "2",
  "41": "2",
  "42": "2",
  "43": "2",
  "44": "2",
  "46": "2",
  "47": "2",
  "48": "2",
  "49": "2",
  "50": "2",
  "52": "2",
  "53": "2",
  "54": "2",
  "55": "2",
  "56": "2",
  "58": "2",
  "59": "2",
  "60": "2",
  "61": "2",
  "62": "2",
  "65": "3",
  "66": "3",
  "67": "3",
  "68": "3",
  "69": "3",
  "71": "3",
  "72": "3",
  "73": "3",
  "74": "3",
  "75": "3",
  "77": "3",
  "78": "3",
  "79": "3",
  "80": "3",
  "81": "3",
  "83": "3",
  "84": "3",
  "85": "3",
  "86": "3",
  "87": "3",
  "89": "3",
  "90": "3",
  "91": "3",
  "92": "3",
  "93": "3",
  "96": "4",
  "97": "4",
  "98": "4",
  "99": "4",
  "100": "4",
  "102": "4",
  "103": "4",
  "104": "4",
  "105": "4",
  "106": "4",
  "108": "4",
  "109": "4",
  "110": "4",
  "111": "4",
  "112": "4",
  "114": "4",
  "115": "4",
  "116": "4",
  "117": "4",
  "118": "4",
  "120": "4",
  "121": "4",
  "122": "4",
  "123": "4",
  "124": "4",
  "127": "5",
  "128": "5",
  "129": "5",
  "130": "5",
  "131": "5",
  "133": "5",
  "134": "5",
  "135": "5",
  "136": "5",
  "137": "5",
  "139": "5",
  "140": "5",
  "141": "5",
  "142": "5",
  "143": "5",
  "145": "5",
  "146": "5",
  "147": "5",
  "148": "5",
  "149": "5",
  "151": "5",
  "152": "5",
  "153": "5",
  "154": "5",
  "155": "5",
  "158": "6",
  "159": "6",
  "160": "6",
  "161": "6",
  "162": "6",
  "164": "6",
  "165": "6",
  "166": "6",
  "167": "6",
  "168": "6",
  "170": "6",
  "171": "6",
  "172": "6",
  "173": "6",
  "174": "6",
  "176": "6",
  "177": "6",
  "178": "6",
  "179": "6",
  "180": "6",
  "182": "6",
  "183": "6",
  "184": "6",
  "185": "6",
  "186": "6",
  "189": "7",
  "190": "7",
  "191": "7",
  "192": "7",
  "193": "7",
  "195": "7",
  "196": "7",
  "197": "7",
  "198": "7",
  "199": "7",
  "201": "7",
  "202": "7",
  "203": "7",
  "204": "7",
  "205": "7",
  "207": "7",
  "208": "7",
  "209": "7",
  "210": "7",
  "211": "7",
  "213": "7",
  "214": "7",
  "215": "7",
  "216": "7",
  "217": "7",
  "220": "8",
  "221": "8",
  "222": "8",
  "223": "8",
  "224": "8",
  "226": "8",
  "227": "8",
  "228": "8",
  "229": "8",
  "230": "8",
  "232": "8",
  "233": "8",
  "234": "8",
  "235": "8",
  "236": "8",
  "238": "8",
  "239": "8",
  "240": "8",
  "241": "8",
  "242": "8",
  "244": "8",
  "245": "8",
  "246": "8",
  "247": "8",
  "248": "8"
}
